XXXXXXXXXXXXXX
X            X
X   S        X
X       G    X
X            X
XXXXXXXXXXXXXX