XXXXXX
X    X
X GS X
X   XX
XXXXXX